1111S11110
0000010001
110100010d
t001111110
0100000001
0111111101
1111111101
00000D01T1
0111110001
0000E01110